111111111111111111111111111111111111111111111111111
1000000000000000000000000C0000000000000000000000001
10C0C00000000000000C000000C000C000000C0000000000001
100000C0C000000C0C00C000000000000000000000C00000001
100000000000111111100111110010001001111111000000001
10000000000010000000000100C010010001000000000000001
1000000000001000C00000010000101000010C0C00000000001
100000000C00111111000001000011000001111111000000001
10000000000010000000C0C1000C10100001000000000000001
1000000000001000C000000100001P01000100000000C000001
100000000000111111100111110010001001111111000000001
100000000000000000000000000C0000000000000CC00000001
1000000000000000000000000000000C00000C00000000C0001
100000000000000000000E00000000000000000000000000001
111111111111111111111111111111111111111111111111111