11111111111111111111111111111
1P00000000000C000000000000001
10000000000000000000000000001
100000000000E0000000000000001
10000000000000000000000000001
10000000000000000000000000001
11111111111111111111111111111
